1,1,1,2,2
5,0,2,2,3
2,4,4,2,3
1,1,1,0,5
2,1,1,1,1
